::::::::::::
:       ::::
  :::::  :::
:  :::::  ::
::  :::::  :
:::  :::::  
::::       :
::::::::::::
#############
::::::::::::
         :::
   :::    ::
    :::    :
:    :::    
::    :::   
:::         
::::::::::::
#############
 : : : : : : 
          :
    ::    ::
     ::    :
:     ::    
 :     :    
 :          
: : : : : : 
#############