: : : : : : :
: : : : : : :
:::::::::::::
:::::::::::::
:::::::::::::
:::::::::::::
: : : : : : :
: : : : : : :
#############

             
: : : : : : :
: : : : : : :
:::::::::::::
:::::::::::::
: : : : : : :
: : : : : : :
             
#############

             
             
: : : : : : :
:::::::::::::
:::::::::::::
: : : : : : :
             
             
#############

             
             
             
: ::: ::: :::
: ::: ::: :::
             
             
             
#############